11111111111111
1P100000000001
10000000000001
10000000000011
10000000000011
100000000001E1
11111111111111