11111111111111
1P00000C0C0001
1000A0010C0001
10000000001001
1000000C0C1001
1000A00C0C1001
1000000C1C0001
1000000C0C0001
1000A0010C0001
10000000001001
1000000C0C1001
1000A00C0C1001
1000000C1C00E1
1000000C0C0001
1000A0010C0001
10000000001001
1000000C0C1001
1000A00C0C1001
1000000C1C0001
11111111111111