11111111111111
1P1000000001E1
10C00000000011
100000C0000011
11111111111111