11111111111111
1P1000000001E1
10C00010000011
100001C1000011
11111111111111